NO textures/N.xpm
SO textures/S.xpm
EA textures/E.xpm
WE textures/W.xpm

F 0,255,0
C 0,0,255

11111111111111111111111111111111111111111
11100011111111111111111111111111111111111
10000010001000001000000010000000001010001
11101010101011101011101110111011101011101
10001000101010101000100000101010000000001
10101110111110101111111010101110111111111
10101010100000000010000010100010100010001
10111011111111111010111110101111111010101
10101010001000001010000010000010100000101
10101010101110111011101011111110111111101
10000010101000001000001010100010001000001
10101000000000000000000000000000101011101
10101000000000000000000000000000000000101
11101000000000000000000000000000111111111
10101000000000000000000000000000100000001
10101100000000000000000000000000101111101
10001000000000000000000000000000000010111
10111000000000000000000000000000111010101
10100000000000000000000000000000001010101
10111000000000000000000000000000101010101
10100000000000000000000000000000101010001
1011100000000000E000000000000000111011101
10101000000000000000000000000000001010101
10101100000000000000000000000000101010101
10001000000000000000000000000000101010101
10101000000000000000000000000000111010111
10101000000000000000000000000000100010001
10101000000000000000000000000000111111101
10101000000000000000000000000000001000001
11101100000000000000000000000000111011111
10001000000000000000000000000000100000001
10111100000000000000000000000000111111101
10100000000000000000000000000000001010001
11101000000000000000000000000000101010101
10001000000000000000000000000000100010101
10101100000000000000000000000000111010111
10101000000000000000000000000000000010001
10101000000000000000000000000000111010101
10101000000000000000000000000000001000101
10101111111010101011101111101011101111101
10100000100010001010000000101010000000101
11111111111111111111111111111111111111111
